R 1280 700

NO ./textures/wall_white.png

SO ./textures/wall_white_blood.png

WE ./textures/Texture_4_Specular.png

EA ./textures/Texture_3_Specular.png
              
S ./textures/ghost3.png

F 140,140,140

C 211,211,211

11111111111111111111111111111111111111111
10000000000000010000000010000000000100111
10001000000111010000100010000011100000001
10001000010001010000100010000000000111111
100020000101N1010000100010000111000000001
10001000010000010000100011111100000000111
10001000010000010000100011111110110000001
10001000011101110000200001000010100110001
10000000000000000000000000000100110000011
11111111111111111111111111111111111111111
